Text	Label
Hoy me levanté con una sonrisa	Felicidad
Recibí una buena noticia en el trabajo	Felicidad
Me encanta pasar tiempo con mis amigos	Felicidad
Esta tarde salí a caminar y me sentí libre	Felicidad
Mi familia está reunida y eso me hace Felicidad	Felicidad
Escuchar mi canción favorita me alegra el día	Felicidad
Hoy todo me está saliendo bien	Felicidad
Me siento agradecido por todo lo que tengo	Felicidad
Terminé un proyecto importante y estoy satisfecho	Felicidad
Me regalaron algo que quería hace mucho	Felicidad
Compartí una comida deliciosa con mi pareja	Felicidad
Disfruté cada minuto del viaje	Felicidad
Hoy es uno de esos días que todo parece perfecto	Felicidad
Logré algo que creía imposible	Felicidad
Mis hijos me abrazaron fuerte al llegar a casa	Felicidad
El sol está radiante y me llena de energía	Felicidad
Encontré dinero en un viejo abrigo y me reí solo	Felicidad
Recibí un mensaje que me hizo el día	Felicidad
Estoy rodeado de personas que me quieren	Felicidad
Hoy me siento pleno y en paz	Felicidad
Tuve una charla hermosa con alguien especial	Felicidad
Me felicitaron por mi trabajo y me hizo sentir bien	Felicidad
Ayudé a alguien y me llenó el corazón	Felicidad
Recordé un lindo momento de mi infancia	Felicidad
Vi una película que me hizo reír mucho	Felicidad
Hoy me siento más vivo que nunca	Felicidad
Canté en la ducha con toda la energía	Felicidad
Me dieron un reconocimiento inesperado	Felicidad
Hice reír a alguien y eso me alegró	Felicidad
Pude dormir bien y desperté renovado	Felicidad
Volví a ver a un amigo después de mucho tiempo	Felicidad
Bailé sin preocuparme por nada	Felicidad
Terminé de leer un libro que me encantó	Felicidad
Recibí un abrazo sincero y cálido	Felicidad
Me encontré con una sorpresa agradable	Felicidad
Todo está en calma y puedo disfrutar del momento	Felicidad
Hoy no tengo preocupaciones, solo alegría	Felicidad
Me siento motivado para empezar nuevos proyectos	Felicidad
Logré superar una meta personal	Felicidad
Salí a correr y me sentí increíble	Felicidad
Alguien me agradeció y eso me emocionó	Felicidad
Escuché buenas noticias de un ser querido	Felicidad
Pude ayudar a resolver un problema y me sentí útil	Felicidad
Sonreí al ver cómo crecen mis plantas	Felicidad
Pude ver el amanecer y fue hermoso	Felicidad
La música que escuché me llenó el alma	Felicidad
Hoy el café me supo mejor que nunca	Felicidad
Disfruté de una charla larga con un amigo	Felicidad
Me tomé un descanso merecido y lo disfruté	Felicidad
Todo lo que soñé está comenzando a cumplirse	Felicidad
Simplemente, hoy estoy feliz sin razón	Felicidad
Estoy muy feliz hoy	Felicidad
Me siento lleno de alegría	Felicidad
Todo va perfecto	Felicidad
Sonreí sin razón alguna	Felicidad
Estoy agradecido por todo	Felicidad
Hoy me siento pleno	Felicidad
Me encanta este momento	Felicidad
Tengo mucha energía	Felicidad
Estoy disfrutando mucho	Felicidad
Estoy rodeado de amor	Felicidad
Me siento motivado	Felicidad
Estoy en paz	Felicidad
Todo me hace sonreír	Felicidad
Hoy es un gran día	Felicidad
Estoy contento con mi vida	Felicidad
Tengo muchas ganas de vivir	Felicidad
Me siento increíble	Felicidad
Nada puede arruinar mi día	Felicidad
Hoy todo sale bien	Felicidad
Estoy sonriendo mucho	Felicidad
Me siento amado	Felicidad
Estoy entusiasmado	Felicidad
Amo cómo va mi día	Felicidad
Estoy muy positivo hoy	Felicidad
Siento una gran felicidad	Felicidad
Estoy viviendo algo hermoso	Felicidad
Todo es alegría hoy	Felicidad
Me siento genial	Felicidad
Estoy en mi mejor momento	Felicidad
Estoy lleno de entusiasmo	Felicidad
Nada me preocupa hoy	Felicidad
Estoy satisfecho con todo	Felicidad
Estoy lleno de luz	Felicidad
Hoy estoy muy animado	Felicidad
Estoy sonriendo sin parar	Felicidad
Estoy feliz con lo que tengo	Felicidad
Estoy celebrando la vida	Felicidad
Me siento renovado	Felicidad
Todo me sale bien hoy	Felicidad
Estoy vibrando alto	Felicidad
Siento amor en el aire	Felicidad
Estoy muy agradecido	Felicidad
Hoy todo es hermoso	Felicidad
Estoy disfrutando el presente	Felicidad
Estoy riendo mucho	Felicidad
Hoy me siento valioso	Felicidad
Estoy muy animado hoy	Felicidad
Mi corazón está contento	Felicidad
Hoy me siento fuerte y feliz	Felicidad
Estoy con una gran sonrisa	Felicidad
Estoy re contento, che	Felicidad  
Qué linda que está la vida, loco	Felicidad  
Me siento de diez hoy	Felicidad  
Todo me sale bien, boludo	Felicidad  
Hoy estoy a full de alegría	Felicidad  
Me puso feliz esa noticia, posta	Felicidad  
Estoy chocho con esto, che	Felicidad  
Me levanté con toda la buena onda	Felicidad  
No paro de sonreír, loco	Felicidad  
Qué lindo día que hace, boludo	Felicidad  
Estoy con el corazón contento	Felicidad  
Todo me llena de alegría hoy	Felicidad  
Estoy rebosante de felicidad, posta	Felicidad  
Me siento un campeón, che	Felicidad  
Qué alegría verte, loco	Felicidad  
Hoy estoy en mi mejor momento	Felicidad  
Me emociona todo esto, boludo	Felicidad  
Estoy pleno y feliz, posta	Felicidad  
Me siento afortunado hoy	Felicidad  
Todo me salió redondo, che	Felicidad  
Estoy lleno de buena vibra, loco	Felicidad  
Qué linda sensación, boludo	Felicidad  
Estoy chocho de la vida, posta	Felicidad  
Me llena el alma esto, che	Felicidad  
Estoy re contento con vos, loco	Felicidad  
No puedo dejar de sonreír, boludo	Felicidad  
Me siento en la gloria hoy	Felicidad  
Qué felicidad que tengo, posta	Felicidad  
Me alegra el día esto, che	Felicidad  
Estoy re motivado, loco	Felicidad  
Me siento con toda la energía, boludo	Felicidad  
Hoy todo es para sonreír, posta	Felicidad  
Estoy re feliz, che	Felicidad  
Me llena el pecho de alegría, loco	Felicidad  
Qué lindo momento, boludo	Felicidad  
Estoy chocho con este logro, posta	Felicidad  
Me siento en paz y contento, che	Felicidad  
Hoy todo me va bien, loco	Felicidad  
No puedo creer lo feliz que estoy, boludo	Felicidad  
Estoy re satisfecho, posta	Felicidad  
Me pone feliz compartir esto, che	Felicidad  
Estoy re contento con todo, loco	Felicidad  
Me llena de orgullo esto, boludo	Felicidad  
Estoy a pleno, posta	Felicidad  
Qué alegría que me da esto, che	Felicidad  
Me siento más vivo que nunca, loco	Felicidad  
Estoy re feliz con vos, boludo	Felicidad  
Me alegra el alma esto, posta	Felicidad  








Hoy me siento vacío por dentro	Tristeza
No tengo ganas de levantarme de la cama	Tristeza
Siento que nadie me entiende	Tristeza
Extraño mucho a alguien que ya no está	Tristeza
Nada me emociona últimamente	Tristeza
Lloro sin saber bien por qué	Tristeza
Todo me cuesta demasiado estos días	Tristeza
Me siento solo, aunque esté rodeado de gente	Tristeza
Perdí algo muy importante para mí	Tristeza
No dejo de pensar en lo que salió mal	Tristeza
Me pesa el corazón todo el tiempo	Tristeza
Quisiera volver atrás y cambiar las cosas	Tristeza
Hoy todo me parece gris y apagado	Tristeza
No tengo fuerzas para seguir	Tristeza
Siento que no soy suficiente	Tristeza
Cada día se siente igual de pesado	Tristeza
El silencio me hace sentir más solo	Tristeza
Me duele ver a los demás tan felices	Tristeza
No encuentro consuelo en nada	Tristeza
Me dijeron algo que me rompió el alma	Tristeza
Me siento una carga para los demás	Tristeza
Me duele el pecho del vacío que siento	Tristeza
Todo lo que me ilusionaba ya no importa	Tristeza
Me siento invisible	Tristeza
No tengo con quién hablar de verdad	Tristeza
Siento que no tengo un lugar en este mundo	Tristeza
Mi corazón está roto	Tristeza
Hoy todo me sale mal	Tristeza
No sé cómo seguir adelante	Tristeza
Tengo el alma cansada	Tristeza
Me desilusioné de alguien que quería mucho	Tristeza
Me cuesta sonreír últimamente	Tristeza
El dolor no se va aunque lo oculte	Tristeza
Estoy lleno de pensamientos tristes	Tristeza
Me siento atrapado en mi propia mente	Tristeza
Hay un vacío en mí que no puedo llenar	Tristeza
Perdí la esperanza	Tristeza
Echo de menos tiempos más felices	Tristeza
Ya no me reconozco en el espejo	Tristeza
No sé cómo pedir ayuda	Tristeza
Estoy agotado emocionalmente	Tristeza
Me decepcioné de mí mismo	Tristeza
Solo quiero desaparecer por un rato	Tristeza
No encuentro motivación para hacer nada	Tristeza
Me duele recordar lo que perdí	Tristeza
Lo intento, pero nada mejora	Tristeza
Ojalá las cosas fueran diferentes	Tristeza
Siento que el mundo sigue sin mí	Tristeza
Nada me consuela hoy	Tristeza
Solo quiero llorar hasta quedarme dormido	Tristeza
Me siento muy triste	Tristeza
Hoy no tengo ganas de nada	Tristeza
Siento un vacío adentro	Tristeza
Todo me cuesta hoy	Tristeza
Estoy desanimado	Tristeza
Nada me alegra	Tristeza
Me siento solo	Tristeza
Hoy no tengo fuerzas	Tristeza
Estoy desmotivado	Tristeza
No quiero hablar con nadie	Tristeza
Estoy llorando en silencio	Tristeza
Siento que todo está mal	Tristeza
Me cuesta levantarme	Tristeza
Estoy sin ganas	Tristeza
Me siento apagado	Tristeza
Todo me supera hoy	Tristeza
Estoy muy bajoneado	Tristeza
Hoy todo me duele	Tristeza
Tengo el ánimo por el suelo	Tristeza
Siento un gran dolor emocional	Tristeza
Me siento olvidado	Tristeza
Estoy atrapado en la tristeza	Tristeza
Siento que no valgo	Tristeza
No tengo ganas de seguir	Tristeza
Estoy con el corazón roto	Tristeza
Hoy no puedo sonreír	Tristeza
Estoy muy decaído	Tristeza
No encuentro consuelo	Tristeza
Estoy agotado emocionalmente	Tristeza
Hoy todo pesa demasiado	Tristeza
Estoy hundido en pensamientos tristes	Tristeza
Me siento perdido	Tristeza
Tengo ganas de llorar	Tristeza
Nada me interesa hoy	Tristeza
Me siento olvidado por todos	Tristeza
Estoy roto por dentro	Tristeza
Todo parece gris	Tristeza
Hoy no encuentro esperanza	Tristeza
Me siento frágil	Tristeza
Estoy lleno de melancolía	Tristeza
Me siento invisible	Tristeza
Hoy me duele el alma	Tristeza
No tengo consuelo	Tristeza
Siento un gran vacío	Tristeza
Estoy sin rumbo	Tristeza
Hoy me siento muy solo	Tristeza
Siento que todo es difícil	Tristeza
Estoy con el ánimo caído	Tristeza
Estoy pasando un mal día	Tristeza
Hoy no me siento bien	Tristeza
Estoy bajoneado, che	Tristeza  
No doy más, loco	Tristeza  
Me siento solo en esta	Tristeza  
Se me partió el corazón	Tristeza  
Estoy medio apagado hoy	Tristeza  
No me sale nada, boludo	Tristeza  
Me siento re vacío, posta	Tristeza  
La verdad, estoy hecho bolsa	Tristeza  
No encuentro salida, loco	Tristeza  
Estoy triste, ni ganas de nada	Tristeza  
Me pesa todo hoy	Tristeza  
Ando medio bajón, viste	Tristeza  
Me quedé sin ganas de nada	Tristeza  
Siento que no avanzo	Tristeza  
Estoy re bajoneado, che	Tristeza  
No puedo parar de pensar en eso	Tristeza  
Se me cayó todo abajo	Tristeza  
Me siento muy solo, posta	Tristeza  
No encuentro luz en el camino	Tristeza  
Estoy con el alma rota	Tristeza  
Me duele el pecho de tristeza	Tristeza  
Siento que me faltás	Tristeza  
No sé qué hacer con esto	Tristeza  
Me dejaron re mal, loco	Tristeza  
Estoy hecho pelota, che	Tristeza  
No me sale una bien	Tristeza  
Me siento perdido en todo	Tristeza  
Estoy medio en la lona	Tristeza  
No me dan ganas ni de salir	Tristeza  
Siento que me ahogo en la tristeza	Tristeza  
Me duele la ausencia	Tristeza  
Ando con el ánimo por el piso	Tristeza  
No puedo dejar de llorar	Tristeza  
Estoy hecho trizas, posta	Tristeza  
Me pesa la soledad	Tristeza  
No sé cómo seguir adelante	Tristeza  
Ando medio vacío, boludo	Tristeza  
Siento que todo se derrumba	Tristeza  
No encuentro fuerzas hoy	Tristeza  
Me siento re dolido, loco	Tristeza  
Estoy sin ganas de nada	Tristeza  
Me duele el alma, che	Tristeza  
No me sale la sonrisa hoy	Tristeza  
Ando medio apagado, boludo	Tristeza  
Me quedé sin esperanzas	Tristeza  
Siento que no valgo nada	Tristeza  
Estoy con el corazón partido	Tristeza  
No puedo con esta tristeza	Tristeza  
Me siento invisible, posta	Tristeza  








Estoy harto de que siempre sea lo mismo	Enojo
No soporto que me mientan en la cara	Enojo
Siempre me ignoran y ya me cansé	Enojo
Me dijeron algo que me hizo estallar	Enojo
Estoy al límite de mi paciencia	Enojo
No puedo creer la injusticia que viví	Enojo
Me sacan de quicio con sus actitudes	Enojo
Otra vez hicieron lo que quisieron sin consultarme	Enojo
No es justo que me culpen por algo que no hice	Enojo
Estoy furioso con todo lo que pasó hoy	Enojo
Me hablaron con un tono que me ofendió mucho	Enojo
Me cansé de ser siempre el que cede	Enojo
Estoy harto de repetir las mismas cosas	Enojo
No escuchan lo que digo y eso me molesta	Enojo
Siempre hacen lo que quieren sin pensar en los demás	Enojo
Me arruinaron el día con su actitud	Enojo
Estoy completamente frustrado con esta situación	Enojo
No me gusta que me subestimen	Enojo
Gritaron sin razón y eso me hizo enojar	Enojo
No tolero más esta falta de respeto	Enojo
Me dejaron esperando y ni avisaron	Enojo
Estoy que exploto de la bronca	Enojo
No tienen consideración por nadie	Enojo
Volvieron a fallarme y eso me enoja	Enojo
Estoy muy molesto con lo que hicieron	Enojo
No cumplieron con lo que prometieron	Enojo
Estoy irritado desde que empezó el día	Enojo
Me hacen perder el tiempo una y otra vez	Enojo
Estoy cansado de aguantar siempre lo mismo	Enojo
Otra vez me dejaron solo con todo el trabajo	Enojo
No me merezco que me traten así	Enojo
Estoy lleno de bronca y no puedo disimularlo	Enojo
Me ignoran y luego actúan como si nada	Enojo
No puedo creer lo mal que manejaron todo	Enojo
Se burlaron de mí y eso me enoja	Enojo
Me gritaron delante de todos sin motivo	Enojo
Siempre tienen una excusa para todo	Enojo
Estoy indignado con esta situación	Enojo
Estoy tan enojado que no quiero hablar con nadie	Enojo
Me trataron de forma injusta	Enojo
No me dieron la oportunidad de explicar	Enojo
Se aprovecharon de mi buena voluntad	Enojo
Estoy fastidiado con su comportamiento	Enojo
Me exigen todo pero no valoran nada	Enojo
Otra vez hicieron lo contrario a lo que pedí	Enojo
Estoy muy enojado con su falta de compromiso	Enojo
Me hicieron sentir mal a propósito	Enojo
No puedo soportar tanta hipocresía	Enojo
Estoy muy molesto por cómo se manejaron	Enojo
Se desentendieron de todo y lo dejaron en mis manos	Enojo
Estoy muy enojado	Enojo
Esto me hizo explotar	Enojo
No soporto esta situación	Enojo
Estoy furioso	Enojo
Me sacaron de quicio	Enojo
Estoy harto de todo	Enojo
Esto me enoja mucho	Enojo
Me irrita demasiado	Enojo
Estoy muy molesto	Enojo
No aguanto más	Enojo
Me saca de las casillas	Enojo
Estoy lleno de rabia	Enojo
Esto me pone mal	Enojo
Estoy muy alterado	Enojo
No tolero esto	Enojo
Estoy a punto de estallar	Enojo
Esto me fastidia mucho	Enojo
Estoy re caliente	Enojo
No quiero hablar del enojo que tengo	Enojo
Estoy furioso por dentro	Enojo
Me hicieron perder la paciencia	Enojo
Estoy al límite	Enojo
No puedo calmarme	Enojo
Estoy rojo de furia	Enojo
Estoy muy frustrado	Enojo
Estoy que grito	Enojo
Esto me colmó la paciencia	Enojo
Me siento traicionado y enojado	Enojo
Estoy muy indignado	Enojo
No puedo con esta bronca	Enojo
Me dejaron sin palabras del enojo	Enojo
Estoy gritando de rabia	Enojo
Estoy completamente irritado	Enojo
Me molesta muchísimo	Enojo
Estoy hirviendo por dentro	Enojo
Me hicieron enojar feo	Enojo
Esto me saca loco	Enojo
Estoy lleno de bronca	Enojo
Estoy muy mal por esta situación	Enojo
Esto no tiene perdón	Enojo
Estoy perdiendo el control	Enojo
Estoy cansado de todo	Enojo
Esto me enfurece	Enojo
Estoy explotando de rabia	Enojo
No aguanto este enojo	Enojo
Me cuesta contenerme	Enojo
Estoy con una bronca tremenda	Enojo
Estoy fuera de mí	Enojo
Me hicieron estallar	Enojo
Estoy enojado de verdad	Enojo
Estoy re caliente, boludo	Enojo  
Qué carajo querés	Enojo  
Me tenés las pelotas llenas	Enojo  
Dejá de joder, pelotudo	Enojo  
No te soporto más, forro	Enojo  
Me calentás la cabeza	Enojo  
Sos un imbécil, dejá de molestar	Enojo  
Me da bronca este quilombo	Enojo  
Andate a la mierda, basura	Enojo  
Estoy al horno con vos	Enojo  
No te banco ni un segundo	Enojo  
Sos un pelotudo bárbaro	Enojo  
Me chupa un huevo todo esto	Enojo  
No me rompas las bolas	Enojo  
Sos un cabeza de termo	Enojo  
Qué carajo hacés, boludo	Enojo  
Estoy podrido de vos	Enojo  
No me hinchés las pelotas	Enojo  
Andá a cagar, gil	Enojo  
Sos un nabo, dejate de joder	Enojo  
Estoy re podrido de esta mierda	Enojo  
Me calenté mal, boludo	Enojo  
No me jodás más	Enojo  
Me tenés re podrido	Enojo  
No te aguanto, forro	Enojo  
Sos un pelotudo de primera	Enojo  
Estoy que exploto, la puta madre	Enojo  
Andá a la concha de tu madre	Enojo  
No me rompas las pelotas más	Enojo  
Sos un inútil, dejá de molestar	Enojo  
Me sacaste, boludo	Enojo  
Estoy re caliente con vos	Enojo  
No me hinchés más las bolas	Enojo  
Me cansaste, pelotudo	Enojo  
Sos un desastre, dejate de joder	Enojo  
Estoy re caliente, la concha de tu madre	Enojo  
No me hables más, gil	Enojo  
Sos un hijo de puta, dejá de joder	Enojo  
Me caliento solo de verte	Enojo  
Dejá de joder, boludo de mierda	Enojo  
Me tenés las pelotas al plato	Enojo  
Estoy que voy a explotar, boludo	Enojo  
Andá a cagar, pelotudo	Enojo  
No te banco ni un minuto más	Enojo  
Sos un pelotudo sin remedio	Enojo  
Me tenés podrido, forro	Enojo  
Estoy re caliente con esta situación	Enojo  
Andate a la mierda, pelotudo	Enojo  
No me hinchés más, gil de mierda	Enojo  








Intento una y otra vez y no lo logro	Frustración
Siempre parece que me falta algo para llegar	Frustración
Hago todo bien y aun así no alcanza	Frustración
No entiendo qué estoy haciendo mal	Frustración
Estoy cansado de dar todo sin resultados	Frustración
Trabajo tanto y no obtengo nada a cambio	Frustración
Cuando estoy por conseguirlo, algo lo arruina	Frustración
Nada sale como lo planeo	Frustración
Estoy bloqueado y no sé cómo seguir	Frustración
Cada intento termina igual: en fracaso	Frustración
Es como si diera vueltas en círculo	Frustración
Siempre que avanzo, aparece un nuevo obstáculo	Frustración
Me esfuerzo mucho pero nadie lo nota	Frustración
Siento que no progreso aunque lo intento	Frustración
Lo tenía casi listo y se arruinó todo	Frustración
Estoy al borde de rendirme	Frustración
No puedo más con este sentimiento de impotencia	Frustración
Me molesta no poder controlar la situación	Frustración
Pongo todo de mí y no alcanza	Frustración
No entiendo por qué no me sale	Frustración
Siento que todo está en mi contra	Frustración
Estoy estancado y no veo salida	Frustración
No consigo lo que quiero por más que me esfuerce	Frustración
Siempre me falta un paso para lograrlo	Frustración
Me agota repetir el mismo error	Frustración
Lo intenté con todas mis fuerzas, y fallé	Frustración
No me dejan avanzar con tantas trabas	Frustración
Estoy frustrado con mis propios límites	Frustración
Pido ayuda y nadie responde	Frustración
Es como hablar con una pared	Frustración
Siento que el tiempo se me escapa sin lograr nada	Frustración
La situación me supera completamente	Frustración
Estoy decepcionado conmigo mismo	Frustración
Ya no sé qué hacer para mejorar	Frustración
No soporto seguir cometiendo los mismos errores	Frustración
Me esfuerzo más que los demás y no lo reconozco	Frustración
Me exigen resultados imposibles	Frustración
No tengo margen para equivocarme y eso me presiona	Frustración
Estoy al límite de lo que puedo soportar	Frustración
Tengo todo para hacerlo y aún así no puedo	Frustración
Lo arruiné todo sin querer	Frustración
Nada parece funcionar últimamente	Frustración
No puedo cumplir con las expectativas	Frustración
Me siento incapaz de resolverlo	Frustración
Estoy harto de que todo dependa de mí	Frustración
Siento que todo esfuerzo es en vano	Frustración
No es justo que me toque siempre lo más difícil	Frustración
Me sobrepasa la situación	Frustración
Estoy frustrado con mi desempeño	Frustración
Otra vez lo intenté y volví a fallar	Frustración
Nadie me da una oportunidad real	Frustración
No logro avanzar	Frustración
Estoy muy frustrado	Frustración
Nada sale como quiero	Frustración
Me siento bloqueado	Frustración
No puedo más con esto	Frustración
Todo me sale mal	Frustración
Estoy estancado	Frustración
No encuentro solución	Frustración
Estoy cansado de intentar	Frustración
Me siento atrapado	Frustración
No entiendo qué pasa	Frustración
Estoy perdiendo la paciencia	Frustración
Nada funciona bien	Frustración
Estoy desanimado	Frustración
No logro entender	Frustración
Esto me agota	Frustración
No encuentro salida	Frustración
Estoy muy decepcionado	Frustración
Me siento sin fuerzas	Frustración
No puedo resolverlo	Frustración
Estoy agotado mentalmente	Frustración
No me sale nada bien	Frustración
Me siento impotente	Frustración
Esto me desmotiva	Frustración
No sé qué hacer	Frustración
Estoy bloqueado mentalmente	Frustración
No logro concentrarme	Frustración
Siento que pierdo tiempo	Frustración
Estoy confundido y frustrado	Frustración
Me cuesta avanzar	Frustración
No puedo cumplirlo	Frustración
Me siento atascado	Frustración
Estoy desilusionado	Frustración
No encuentro la manera	Frustración
Estoy sin ideas	Frustración
Me siento frustrado conmigo mismo	Frustración
No puedo continuar	Frustración
Estoy sin motivación	Frustración
Esto me está superando	Frustración
No logro completar	Frustración
Me siento derrotado	Frustración
Estoy muy cansado mentalmente	Frustración
No encuentro respuesta	Frustración
Estoy perdiendo la esperanza	Frustración
Esto no tiene sentido	Frustración
Me siento paralizado	Frustración
Estoy muy molesto conmigo	Frustración
No sé cómo seguir	Frustración
Me tiene podrido esto	Frustración  
No da más esta situación	Frustración  
Estoy al horno con esto	Frustración  
No sale ni a palos	Frustración  
Estoy re quemado/a	Frustración  
No entiendo nada ya	Frustración  
Me da una bronca terrible	Frustración  
Esto no tiene sentido	Frustración  
No puedo más con esto	Frustración  
Me siento estancado/a	Frustración  
Todo me sale mal	Frustración  
Estoy a punto de explotar	Frustración  
No puedo avanzar	Frustración  
Estoy harto/a de esperar	Frustración  
Me cansa la cabeza	Frustración  
Esto es un bajón total	Frustración  
No encuentro la vuelta	Frustración  
Estoy re desanimado/a	Frustración  
Me agota esta situación	Frustración  
No logro entenderlo	Frustración  
Esto me está matando	Frustración  
Me quema la cabeza	Frustración  
Estoy podrido/a de esto	Frustración  
No me sale ni en pedo	Frustración  
Me frustra un montón	Frustración  
No puedo controlar esto	Frustración  
Estoy perdido/a ya	Frustración  
Me cuesta un montón	Frustración  
No sé qué hacer más	Frustración  
Esto es un desastre	Frustración  
Me siento bloqueado/a	Frustración  
No me banco más esto	Frustración  
Estoy re irritado/a	Frustración  
Me quiero pegar un tiro	Frustración  
Estoy a full de bronca	Frustración  
No funciona nada	Frustración  
Esto me saca la cabeza	Frustración  
No me queda paciencia	Frustración  
Me siento al límite	Frustración  
Estoy re frustrado/a	Frustración  
No encuentro solución	Frustración  
Me da ganas de llorar	Frustración  
Estoy sin salida	Frustración  
Me tienen podrido/a	Frustración  
No aguanto más esto	Frustración  
Estoy re caliente	Frustración  
Me siento atrapado/a	Frustración  
Esto no va para ningún lado	Frustración  
Me saca la cabeza todo esto	Frustración  










Tengo miedo de lo que pueda pasar	Miedo
Siento que algo malo está por suceder	Miedo
No puedo dejar de pensar en todas las cosas que podrían salir mal	Miedo
Estoy paralizado por el miedo	Miedo
Me da miedo hablar en público	Miedo
Cada ruido me hace saltar del susto	Miedo
Tengo miedo de quedarme solo	Miedo
No me atrevo a enfrentar esta situación	Miedo
El futuro me asusta mucho	Miedo
No sé si voy a poder con esto	Miedo
Me aterra decepcionar a los que confían en mí	Miedo
No quiero salir de casa, tengo miedo	Miedo
Tengo miedo de perder a alguien que amo	Miedo
No puedo dormir por todo lo que me preocupa	Miedo
Tengo miedo de no ser suficiente	Miedo
Me da pánico equivocarme frente a los demás	Miedo
Estoy constantemente pensando en lo peor	Miedo
No sé cómo enfrentar mis miedos	Miedo
Tengo miedo de que me pase algo malo	Miedo
Cada vez que estoy solo, me siento inseguro	Miedo
Siento un nudo en el estómago del miedo	Miedo
Tengo miedo de que todo se derrumbe	Miedo
Me da miedo pedir ayuda y que me rechacen	Miedo
No puedo dejar de temblar	Miedo
Me asusta lo rápido que cambia todo	Miedo
Tengo miedo de fallar en lo que me propuse	Miedo
Me da miedo que me juzguen	Miedo
Estoy muy nervioso, todo me da miedo hoy	Miedo
El miedo me impide avanzar	Miedo
Tengo miedo de que me hagan daño	Miedo
Me cuesta respirar cuando tengo miedo	Miedo
Me da miedo perder el control	Miedo
No quiero enfrentarme a esa conversación	Miedo
Estoy aterrado con lo que está pasando	Miedo
Me asusta pensar en lo que podría haber pasado	Miedo
No puedo estar tranquilo, algo me da miedo	Miedo
Siento miedo sin saber exactamente por qué	Miedo
Tengo miedo de equivocarme de nuevo	Miedo
No quiero volver a sentir ese terror	Miedo
Cada vez que pienso en eso me invade el miedo	Miedo
No puedo dejar de sentirme amenazado	Miedo
Me da miedo mostrar cómo me siento	Miedo
Tengo miedo de que todo se complique	Miedo
Estoy en alerta todo el tiempo por miedo	Miedo
No me atrevo a dar el primer paso	Miedo
Ese lugar me genera un miedo inexplicable	Miedo
Siento que el miedo me domina	Miedo
Tengo miedo de no poder defenderme	Miedo
Me da miedo que me abandonen	Miedo
No puedo enfrentar ese recuerdo, me da miedo	Miedo
El miedo me acompaña desde que desperté	Miedo
Tengo miedo	 Miedo
Estoy asustado	 Miedo
No me siento seguro	 Miedo
Siento temor	 Miedo
Estoy nervioso	 Miedo
Me siento vulnerable	 Miedo
Tengo miedo de fallar	 Miedo
No quiero arriesgarme	 Miedo
Me preocupa lo que pasará	 Miedo
Siento ansiedad	 Miedo
Tengo miedo al cambio	 Miedo
Me da miedo lo desconocido	 Miedo
Estoy inquieto	 Miedo
Siento pánico	 Miedo
No sé qué hacer	 Miedo
Estoy temeroso	 Miedo
Me siento inseguro	 Miedo
Tengo miedo de perder	 Miedo
Siento miedo interior	 Miedo
Estoy preocupado	 Miedo
No me siento tranquilo	 Miedo
Tengo miedo al rechazo	 Miedo
Siento incertidumbre	 Miedo
Estoy temblando	 Miedo
Me siento acorralado	 Miedo
Tengo miedo a lo peor	 Miedo
Siento miedo constante	 Miedo
Estoy en alerta	 Miedo
Me da miedo hablar	 Miedo
No quiero enfrentar esto	 Miedo
Estoy paralizado	 Miedo
Siento miedo intenso	 Miedo
Tengo miedo a equivocarme	 Miedo
Estoy preocupado por el futuro	 Miedo
Siento miedo profundo	 Miedo
Tengo miedo de sufrir	 Miedo
Estoy preocupado por mí	 Miedo
Me siento nervioso	 Miedo
Tengo miedo de ser juzgado	 Miedo
Siento temor constante	 Miedo
Estoy temeroso y preocupado	 Miedo
Me da miedo avanzar	 Miedo
No me siento protegido	 Miedo
Tengo miedo de perder el control	 Miedo
Siento miedo cuando estoy solo	 Miedo
Estoy inquieto y asustado	 Miedo
Me siento inseguro de mí	 Miedo
Tengo miedo de enfrentar problemas	 Miedo
No quiero arriesgar nada	 Miedo
Me agarró un cagazo	Miedo  
No sé qué hacer, posta	Miedo  
Me dio un susto bárbaro	Miedo  
Estoy re asustado/a	Miedo  
No puedo ni moverme	Miedo  
Me tiemblan las patas	Miedo  
Tengo la piel de gallina	Miedo  
Siento que me voy a morir	Miedo  
Estoy al horno, posta	Miedo  
Me está agarrando la locura	Miedo  
No sé si aguanto esto	Miedo  
Tengo miedo de lo que viene	Miedo  
Me estoy por caer a pedazos	Miedo  
No puedo ni respirar bien	Miedo  
Siento que me paralizo	Miedo  
Estoy con el corazón en la boca	Miedo  
No me animé a hacer nada	Miedo  
Tengo un nudo en la garganta	Miedo  
Me está carcomiendo el miedo	Miedo  
No doy pie con bola, estoy nervioso/a	Miedo  
Tengo miedo de equivocarme	Miedo  
Me estoy cagando todo	Miedo  
No sé cómo salir de esta	Miedo  
Estoy al borde del colapso	Miedo  
Siento que me falta el aire	Miedo  
Me está dando ansiedad mal	Miedo  
Tengo un frío que me recorre todo	Miedo  
No puedo dejar de pensar en eso	Miedo  
Estoy hecho/a un manojo de nervios	Miedo  
Me tiemblan las manos	Miedo  
Me agarró un cagazo bárbaro	Miedo  
No puedo sacarme esto de la cabeza	Miedo  
Estoy medio que me quiero rajar	Miedo  
Me siento atrapado/a	Miedo  
No sé si voy a poder con esto	Miedo  
Tengo miedo de hablar	Miedo  
Me tiemblan las piernas	Miedo  
No me puedo concentrar	Miedo  
Me está matando la incertidumbre	Miedo  
Estoy a punto de explotar	Miedo  
Me cuesta hasta pensar	Miedo  
Estoy al palo de nervioso/a	Miedo  
Me agarro un ataque de pánico	Miedo  
No puedo ni dormir por esto	Miedo  
Me siento como en una pesadilla	Miedo  
No sé qué va a pasar	Miedo  
Estoy con el corazón a mil	Miedo  
No me quiero ni mover	Miedo  
Me siento vulnerable	Miedo  












No pude decir nada del nerviosismo que tenía	Vergüenza
Sentí que todos me miraban y me puse rojo	Vergüenza
Me equivoqué frente a todos y quise desaparecer	Vergüenza
Tropecé en público y no sabía dónde meterme	Vergüenza
Dije algo fuera de lugar y me arrepentí al instante	Vergüenza
Me temblaba la voz de la vergüenza	Vergüenza
No quería que supieran lo que hice	Vergüenza
Me sentí muy expuesto y vulnerable	Vergüenza
Hablé sin pensar y luego me arrepentí	Vergüenza
Me sentí torpe frente a todos	Vergüenza
No podía sostener la mirada de la vergüenza	Vergüenza
Me puse a llorar y no pude evitarlo	Vergüenza
Tuve que presentarme y no me salieron las palabras	Vergüenza
No recordé nada durante la exposición	Vergüenza
Me di cuenta de que todos se reían de mí	Vergüenza
Me descubrieron en una mentira piadosa	Vergüenza
Se burlaron de mi forma de vestir	Vergüenza
Se rieron de lo que dije sin mala intención	Vergüenza
No sabía que había cometido un error tan evidente	Vergüenza
Me avergoncé de mis propias reacciones	Vergüenza
Dije algo tonto y me sentí ridículo	Vergüenza
Me sentí fuera de lugar todo el tiempo	Vergüenza
No quería que nadie me viera así	Vergüenza
No fui capaz de hablar en la reunión	Vergüenza
Me miraron raro por cómo me expresé	Vergüenza
Me quedé en blanco y no supe qué hacer	Vergüenza
Me sentí un fraude frente a los demás	Vergüenza
Me corrigieron delante de todos	Vergüenza
Me olvidé del nombre de alguien importante	Vergüenza
Me vi reflejado y no me gustó lo que vi	Vergüenza
Me notaron inseguro y eso me hizo sentir peor	Vergüenza
Fui el único que no entendió la consigna	Vergüenza
Tuve que pedir ayuda y me dio mucha vergüenza	Vergüenza
No pude ocultar que estaba nervioso	Vergüenza
Me sentí inferior al resto	Vergüenza
Me manché la ropa y todos lo notaron	Vergüenza
Me señalaron por mi error sin tacto	Vergüenza
No quería que vieran mis cosas personales	Vergüenza
Hablaron de mí como si no estuviera presente	Vergüenza
Se dieron cuenta de mi torpeza	Vergüenza
Me temblaban las manos al hablar	Vergüenza
Me sentí ridículo por cómo reaccioné	Vergüenza
Me expuse sin querer y fue incómodo	Vergüenza
Me preguntaron algo que no sabía responder	Vergüenza
Olvidé algo importante y todos lo notaron	Vergüenza
Tuve que admitir que no sabía hacerlo	Vergüenza
Me puse nervioso frente a alguien que me gusta	Vergüenza
Me sentí inútil en esa situación	Vergüenza
Me equivoqué y todos lo escucharon	Vergüenza
Se dieron cuenta de que estaba mintiendo	Vergüenza
No podía dejar de pensar en lo mal que actué	Vergüenza
Me siento avergonzado	Vergüenza
No quiero que me vean	Vergüenza
Quisiera esconderme	Vergüenza
Me sonrojo mucho	Vergüenza
Siento que todos me juzgan	Vergüenza
No sé dónde mirar	Vergüenza
Estoy incómodo	Vergüenza
Quiero desaparecer	Vergüenza
Me siento torpe	Vergüenza
Temo hacer el ridículo	Vergüenza
No quiero hablar	Vergüenza
Me siento pequeño	Vergüenza
Estoy nervioso por esto	Vergüenza
No me gusta que me miren	Vergüenza
Siento que fallé	Vergüenza
Me da miedo equivocarme	Vergüenza
Quisiera no haberlo hecho	Vergüenza
Estoy rojo de la cara	Vergüenza
Me siento inseguro	Vergüenza
Quisiera pedir perdón	Vergüenza
No me gusta mi error	Vergüenza
Siento que hice mal	Vergüenza
Me siento ridículo	Vergüenza
Estoy preocupado por mi imagen	Vergüenza
No quiero que sepan	Vergüenza
Me siento humillado	Vergüenza
Quisiera que nadie lo sepa	Vergüenza
Siento que decepcioné	Vergüenza
Estoy incómodo con la atención	Vergüenza
Me siento fuera de lugar	Vergüenza
No quiero que me recuerden	Vergüenza
Me siento inseguro de mí	Vergüenza
Siento que todos me miran mal	Vergüenza
No puedo enfrentar a nadie	Vergüenza
Quisiera que pase rápido	Vergüenza
Me siento culpable	Vergüenza
Tengo miedo de hablar	Vergüenza
Siento que me equivoqué	Vergüenza
No quiero que me juzguen	Vergüenza
Me siento mal por lo que hice	Vergüenza
Estoy preocupado por lo que dirán	Vergüenza
Quisiera borrarlo de mi mente	Vergüenza
Me siento atrapado	Vergüenza
No sé cómo pedir disculpas	Vergüenza
Me siento nervioso	Vergüenza
Quiero evitar esta situación	Vergüenza
Siento que no encajo	Vergüenza
Estoy muy apenado	Vergüenza
Me puse colorado/a	Verguenza  
Qué papelón que hice	Verguenza  
No sé dónde meterme	Verguenza  
Quedé re mal parado/a	Verguenza  
Me salieron los colores	Verguenza  
Qué bochorno, posta	Verguenza  
Me quiero esconder ya	Verguenza  
Hice un mamarracho	Verguenza  
Me siento un/a boludo/a	Verguenza  
No sabía dónde mirar	Verguenza  
Qué bajón que pasó eso	Verguenza  
Quedé como un/a gil	Verguenza  
No me da la cara para nada	Verguenza  
Me tragué la tierra	Verguenza  
Me agarró una vergüenza bárbara	Verguenza  
Me quiero escabullir rápido	Verguenza  
Quedé para el aplauso, pero de los malos	Verguenza  
Me miraron todos, qué bajón	Verguenza  
No paro de pensar en el papelón	Verguenza  
Me siento un desastre total	Verguenza  
Quedé como un/a boludo/a bárbaro/a	Verguenza  
Ni ganas de salir ahora	Verguenza  
Me corté solo/a	Verguenza  
Qué desastre hice, la verdad	Verguenza  
No doy pie con bola	Verguenza  
Estoy rojo/a como un tomate	Verguenza  
Me tengo que hacer invisible	Verguenza  
No puedo creer lo que dije	Verguenza  
Qué vergüenza ajena me da	Verguenza  
Me quiero borrar del mapa	Verguenza  
Me patinó todo en ese momento	Verguenza  
Quedé más pegado que chicle en el pelo	Verguenza  
Me siento un/a salame	Verguenza  
Ni ganas de volver a ese lugar	Verguenza  
Me quedé sin palabras, pero mal	Verguenza  
Hice el ridículo, posta	Verguenza  
Me caí de culo con lo que dije	Verguenza  
Quedé como un/a trompita	Verguenza  
Me quemé vivo/a	Verguenza  
No sé cómo arreglar este papelón	Verguenza  
Me dieron ganas de salir corriendo	Verguenza  
Quedé mal parado/a en la charla	Verguenza  
Me tapé la cara y me fui	Verguenza  
No quiero que me vea nadie	Verguenza  
Me siento un/a tonto/a bárbaro/a	Verguenza  
Quedé como un/a pelotudo/a	Verguenza  
No puedo sacarme esto de la cabeza	Verguenza  
Me quiero matar del bochorno	Verguenza  
Qué bajón haber hecho eso	Verguenza  
Me perdí en la conversación	Verguenza  











Te amo con todo mi corazón	Amor
No dejo de pensar en ti ni un segundo	Amor
Tu sonrisa ilumina mis días	Amor
Eres lo mejor que me ha pasado	Amor
Cada momento a tu lado es especial	Amor
Me haces sentir completo	Amor
No necesito nada más que estar contigo	Amor
Tu amor me da fuerzas para seguir	Amor
Siento mariposas cada vez que te veo	Amor
Eres mi persona favorita en el mundo	Amor
Te elijo hoy y siempre	Amor
Mi corazón late más fuerte por ti	Amor
No hay nadie como tú	Amor
Quiero envejecer contigo	Amor
Tu mirada me llena de paz	Amor
Estar contigo es mi lugar feliz	Amor
No imagino mi vida sin ti	Amor
Cada día me enamoro más de ti	Amor
Gracias por existir en mi vida	Amor
Tu voz me tranquiliza como nada más	Amor
Solo tú sabes cómo hacerme sonreír	Amor
Cuando estoy contigo, el mundo desaparece	Amor
A tu lado todo tiene sentido	Amor
Eres mi refugio y mi hogar	Amor
Te pienso incluso cuando no debería	Amor
Me haces creer en el amor verdadero	Amor
Tienes un lugar eterno en mi corazón	Amor
Me haces mejor persona solo por estar en mi vida	Amor
Tu ternura me derrite el alma	Amor
Quiero abrazarte y no soltarte nunca más	Amor
No hay día que no te extrañe	Amor
Contigo todo es más fácil	Amor
Eres la razón de mi felicidad	Amor
Me haces sentir amado como nunca antes	Amor
Tu presencia llena de luz mi corazón	Amor
Mi amor por ti no tiene límites	Amor
Quisiera detener el tiempo cuando estoy contigo	Amor
No necesito palabras, tu mirada lo dice todo	Amor
Nuestro amor es lo más real que conozco	Amor
Eres mi todo, mi sol y mi calma	Amor
Gracias por enseñarme lo que es amar de verdad	Amor
Me haces sentir en casa con solo una caricia	Amor
Tu amor es mi mayor tesoro	Amor
No hay distancia que debilite lo que siento	Amor
Amarte es lo más hermoso que me ha pasado	Amor
No importa lo que pase, siempre te amaré	Amor
Me haces sentir seguro y querido	Amor
Cada "te amo" tuyo es música para mí	Amor
Eres la persona por la que todo vale la pena	Amor
Mi corazón te pertenece	Amor
Amo cada parte de ti, incluso tus imperfecciones	Amor
Te quiero mucho	Amor
Me importas mucho	Amor
Siento cariño por ti	Amor
Estoy enamorado	Amor
Me haces feliz	Amor
Pienso en ti siempre	Amor
Eres muy especial	Amor
Te extraño mucho	Amor
Quiero estar contigo	Amor
Me haces sonreír	Amor
Siento ternura por ti	Amor
Me encanta tu voz	Amor
Estoy feliz contigo	Amor
Quiero abrazarte	Amor
Me haces sentir bien	Amor
Eres mi persona favorita	Amor
Me siento seguro contigo	Amor
Quiero cuidarte	Amor
Eres mi todo	Amor
Te admiro mucho	Amor
Me haces soñar	Amor
Me llena el corazón	Amor
Quiero besarte	Amor
Siento pasión por ti	Amor
Eres mi inspiración	Amor
Te pienso a cada instante	Amor
Quiero compartir mi vida	Amor
Me haces sentir vivo	Amor
Estoy agradecido por ti	Amor
Eres mi alegría	Amor
Me encanta tu sonrisa	Amor
Quiero apoyarte siempre	Amor
Me siento completo contigo	Amor
Te adoro	Amor
Siento paz contigo	Amor
Me haces sentir amado	Amor
Eres mi felicidad	Amor
Me enamoro más cada día	Amor
Quiero estar a tu lado	Amor
Me haces soñar despierto	Amor
Eres mi refugio	Amor
Quiero protegerte	Amor
Me gusta tu compañía	Amor
Siento conexión contigo	Amor
Eres mi corazón	Amor
Me siento querido	Amor
Quiero compartir momentos	Amor
Eres mi mundo	Amor
Te banco un montón	Amor  
Sos lo más que me pasó	Amor  
Me encanta estar con vos	Amor  
Sos mi todo, posta	Amor  
No paro de pensar en vos	Amor  
Me hacés re feliz	Amor  
Sos mi persona favorita	Amor  
Te quiero un montón	Amor  
Cada día te quiero más	Amor  
Sos mi alegría diaria	Amor  
Me encanta tu sonrisa	Amor  
Sos lo mejor que tengo	Amor  
No me imagino sin vos	Amor  
Me volvés loco/a	Amor  
Sos mi paz y mi loco	Amor  
Quiero estar siempre a tu lado	Amor  
Sos mi sol en días nublados	Amor  
Me hacés latir el corazón	Amor  
Te amo con todo lo que soy	Amor  
Sos mi lugar feliz	Amor  
No dejo de extrañarte	Amor  
Me encantaría darte un abrazo ahora	Amor  
Sos la persona que soñé	Amor  
Me hacés sentir vivo/a	Amor  
Sos mi media naranja posta	Amor  
Quiero que seas feliz conmigo	Amor  
Cada momento con vos es único	Amor  
Sos mi refugio seguro	Amor  
Me vuelvo un bobo/a por vos	Amor  
Te necesito cerca siempre	Amor  
Sos el amor de mi vida	Amor  
Me alegra el alma verte	Amor  
Quiero hacerte feliz	Amor  
Sos mi cuento de hadas real	Amor  
Me hacés brillar los ojos	Amor  
Sos mi mejor decisión	Amor  
No puedo dejar de pensarte	Amor  
Quiero caminar a tu lado siempre	Amor  
Sos mi calma y mi tormenta	Amor  
Me sacás sonrisas todo el día	Amor  
Sos mi compañero/a ideal	Amor  
Te llevo en el corazón	Amor  
Me haces sentir especial	Amor  
Sos la luz que me guía	Amor  
Quiero vivir mil historias con vos	Amor  
Me encantaría un beso ahora	Amor  
Sos mi sueño cumplido	Amor  
Te adoro con todo mi ser	Amor  
Sos mi presente y mi futuro	Amor  
Me enamoro más cada día	Amor  










¡Qué sorpresa, no me lo esperaba para nada!	Sarcasmo
Claro, porque eso siempre funciona perfecto	Sarcasmo
¡Qué idea tan brillante, cómo no se me ocurrió antes!	Sarcasmo
Genial, justo lo que necesitaba, más problemas	Sarcasmo
Oh, sí, porque eso tiene mucho sentido	Sarcasmo
Me encanta cuando todo sale mal, es lo mejor	Sarcasmo
Por supuesto, eso resolverá todos los problemas	Sarcasmo
¡Qué bueno que me avisaste, justo a tiempo!	Sarcasmo
Sí, seguro, porque tú siempre tienes la razón	Sarcasmo
Qué maravilla, otro día increíble en la oficina	Sarcasmo
Fantástico, justo lo que quería escuchar	Sarcasmo
Claro, porque la paciencia es infinita aquí	Sarcasmo
Oh, qué amable de tu parte hacer eso otra vez	Sarcasmo
Sí, me encanta esperar horas para nada	Sarcasmo
Por supuesto, tú sabes mejor que nadie	Sarcasmo
Qué gran idea ignorar ese detalle importante	Sarcasmo
Perfecto, justo lo que necesitaba para arruinar mi día	Sarcasmo
Claro, porque nadie más podría hacerlo mejor	Sarcasmo
Oh, qué sorpresa que no funcionó como esperábamos	Sarcasmo
Sí, hacer todo a último momento siempre funciona	Sarcasmo
Qué suerte la mía tener que lidiar con esto	Sarcasmo
Fantástico, otro error que nadie vio venir	Sarcasmo
Por supuesto, eso tiene total sentido lógico	Sarcasmo
Oh, sí, eso fue súper útil, gracias	Sarcasmo
Claro, porque hacer lo contrario siempre es mejor	Sarcasmo
Qué bien, más trabajo para hoy, justo lo que quería	Sarcasmo
Sí, claro, porque las reglas son para romperlas	Sarcasmo
Genial, otra reunión que podría haber sido un correo	Sarcasmo
Oh, qué buena idea dejar todo para el último minuto	Sarcasmo
Por supuesto, no hay mejor momento para esto que ahora	Sarcasmo
Fantástico, más complicaciones para resolver	Sarcasmo
Sí, porque eso es exactamente lo que necesitábamos	Sarcasmo
Qué maravilla tener que repetirlo todo otra vez	Sarcasmo
Claro, porque la tecnología nunca falla	Sarcasmo
Oh, qué sorpresa que el plan no salió bien	Sarcasmo
Por supuesto, no hay problema en ignorar los detalles	Sarcasmo
Sí, porque perder tiempo es lo más productivo	Sarcasmo
Genial, más contratiempos para mi lista	Sarcasmo
Qué suerte que todo esté tan bajo control	Sarcasmo
Claro, porque no hay mejor forma de hacerlo	Sarcasmo
Oh, sí, eso fue súper claro, gracias por la explicación	Sarcasmo
Por supuesto, todo está perfectamente organizado	Sarcasmo
Sí, porque hacer las cosas a medias siempre funciona	Sarcasmo
Fantástico, más obstáculos para superar	Sarcasmo
Qué maravilla tener que empezar de nuevo	Sarcasmo
Claro, porque nadie puede hacerlo mejor que yo	Sarcasmo
Oh, qué sorpresa que haya un problema nuevo	Sarcasmo
Por supuesto, eso fue muy útil, sin duda	Sarcasmo
Sí, porque complicar las cosas es mi especialidad	Sarcasmo
Qué sorpresa, nunca lo hubiera imaginado	Sarcasmo  
Claro, eso tiene todo el sentido del mundo	Sarcasmo  
¡Qué idea tan brillante!	Sarcasmo  
Seguro, eso va a funcionar perfecto	Sarcasmo  
No, para nada, me encanta esperar horas	Sarcasmo  
Sí, porque eso es justo lo que necesitaba	Sarcasmo  
Genial, justo lo que quería, gracias	Sarcasmo  
¡Qué amable, de verdad!	Sarcasmo  
Por supuesto, porque todo sale siempre bien	Sarcasmo  
Me encanta cuando pasa esto, no	Sarcasmo  
Oh sí, qué buena decisión	Sarcasmo  
Qué suerte tengo, siempre me toca a mí	Sarcasmo  
Claro, porque a nadie le importa eso	Sarcasmo  
¡Qué conveniente, justo a tiempo!	Sarcasmo  
Seguro, qué gran plan, ja	Sarcasmo  
Me fascina cuando me ignoran	Sarcasmo  
Por supuesto que quiero más problemas	Sarcasmo  
Claro, ponme más trabajo, por favor	Sarcasmo  
Oh sí, qué divertido es esperar	Sarcasmo  
Me alegra que lo hayas hecho mal	Sarcasmo  
Qué maravilla, otra reunión inútil	Sarcasmo  
Genial, otra vez el mismo error	Sarcasmo  
Por supuesto que me importa, claro	Sarcasmo  
Sí, porque no tenía nada mejor que hacer	Sarcasmo  
Oh, qué sorpresa, otro problema	Sarcasmo  
Me encanta cuando cambian las reglas	Sarcasmo  
Claro, porque eso es justo lo que pedí	Sarcasmo  
Qué bien, justo lo que quería evitar	Sarcasmo  
Sí, qué original tu idea, ja	Sarcasmo  
Oh, qué interesante explicación, de verdad	Sarcasmo  
Por supuesto, me encanta perder tiempo	Sarcasmo  
Claro, lo hice a propósito, ja	Sarcasmo  
Qué divertido es repetir lo mismo	Sarcasmo  
Genial, otro día perfecto para errores	Sarcasmo  
Me encanta cuando me ignoran completamente	Sarcasmo  
Claro, porque todo es tan sencillo	Sarcasmo  
Oh sí, qué bien que falló todo	Sarcasmo  
Por supuesto que no me molesta, claro	Sarcasmo  
Sí, qué suerte que llegué tarde	Sarcasmo  
Me fascina cuando todo sale mal	Sarcasmo  
Qué agradable sorpresa, nada	Sarcasmo  
Genial, más trabajo inesperado	Sarcasmo  
Claro, porque eso era lo que necesitaba	Sarcasmo  
Oh, qué sorpresa, otra vez lo mismo	Sarcasmo  
Por supuesto, qué gran idea, ja	Sarcasmo  
Sí, me encanta cuando me ignoran	Sarcasmo  
Me alegra que todo haya salido mal	Sarcasmo  
Qué maravilloso día para problemas	Sarcasmo  
Claro, porque siempre soy el culpable	Sarcasmo  
¡Qué genio, che!	Sarcasmo  
Obvio, eso pinta bárbaro, posta	Sarcasmo  
Re copado, justo lo que necesitaba	Sarcasmo  
Claro, porque todo sale de diez, viste	Sarcasmo  
Sí, re piola esperar una hora	Sarcasmo  
Tal cual, me encanta cuando me chamuyan	Sarcasmo  
Qué buena idea, no sé cómo no se me ocurrió	Sarcasmo  
Obvio, esto va a andar joya	Sarcasmo  
Sos un capo, posta que sí	Sarcasmo  
¡Qué grosso, loco!	Sarcasmo  
Sí, seguro que no va a romper nada	Sarcasmo  
Re lindo cuando te hacen esperar, posta	Sarcasmo  
Genial, justo lo que quería evitar, viste	Sarcasmo  
Ah, qué copado que se rompió todo	Sarcasmo  
Obvio que me copa laburar de más	Sarcasmo  
Qué lindo que nadie me escucha, posta	Sarcasmo  
Sí, qué original, otra vez lo mismo	Sarcasmo  
Re divertido esperar y que no pase nada	Sarcasmo  
Claro, porque esto siempre funciona bien	Sarcasmo  
Obvio que me encanta que me chamuyen	Sarcasmo  
Qué alegría, otra reunión que no sirve para nada	Sarcasmo  
Re bien, justo cuando llego, se pudre todo	Sarcasmo  
Obvio, sos un capo, me haces reír	Sarcasmo  
Sí, genial que me caguen, posta	Sarcasmo  
Qué bárbaro, más laburo sin aviso	Sarcasmo  
Claro, porque lo hago por gusto	Sarcasmo  
Obvio que quiero problemas, dale	Sarcasmo  
Sí, me encanta que me ignoren, posta	Sarcasmo  
Qué copado que cambien todo a último momento	Sarcasmo  
Re bueno, me encanta que me metan en líos	Sarcasmo  
Obvio que me copa repetir lo mismo	Sarcasmo  
Sí, justo hoy tengo tiempo para esto	Sarcasmo  
Qué lindo que todo salga para el orto	Sarcasmo  
Re piola que me dejen colgado, posta	Sarcasmo  
Obvio, qué suerte que falló todo justo ahora	Sarcasmo  
Sí, re lindo que me carguen de laburo	Sarcasmo  
Qué fenómeno, otra vez me chamuyan	Sarcasmo  
Claro, porque sos un genio, posta	Sarcasmo  
Obvio, me copa que me hagan esperar	Sarcasmo  
Sí, re lindo que me ignoren siempre	Sarcasmo  
Qué copado que me echen la culpa a mí	Sarcasmo  
Re bueno, más problemas para mí	Sarcasmo  
Obvio, me encanta que me rompan las bolas	Sarcasmo  
Sí, genial que me dejen para último	Sarcasmo  
Qué lindo que todo sea un desastre	Sarcasmo  
Re copado que me saltee sin avisar	Sarcasmo  
Obvio, sos un capo, posta que sí	Sarcasmo  
Sí, me encanta que me chamuyen siempre	Sarcasmo  
Qué fenómeno que me carguen otra vez	Sarcasmo  
Re lindo que me dejen esperando horas	Sarcasmo  







